11111111
10000011
11100001
10000W01
11100001
10001001
10001001
11111111
